1111111111111111111111111111111111
1C0000000000000C000E0C00000000P001
1111111111111111111111111111111111
