11111111111111111111111111111111111111111111111111111111111111111111111111111
11111111111111111111111111111111111111111111111111111111111111111111111111111
11111111111111111111111111111111111111111111111111111111111111111111111111111
11111111000000000000000000000000000000000000001111111111111111111111111111111
11111111000000000000000000000000000000000000001111111111111111111111111111111
11111111000000000000000000000000000000000000001111111111111111111111111111111
1111111100000P000000000000000000000000000000001111111111111111111111111111111
1111111100000000E000000000000000000000000000001111111111111111111111111111111
11111111000000000000000000000000000000000000001111111111111111111111111111111
11111111000000000000000000000000000000000000001111111111111111111111111111111
1111111100000000000000000000000C000000000000001111111111111111111111111111111
11111111000000000000000000000000000000000000001111111111111111111111111111111
11111111000000000000000000000000000000000000001111111111111111111111111111111
11111111000000000000000000000000000000000000001111111111111111111111111111111
11111111000000000000000000000000000000000000001111111111111111111111111111111
11111111000000000000000000000000000000000000001111111111111111111111111111111
11111111000000000000000000000000000000000000001111111111111111111111111111111
11111111000000000000000000000000000000000000001111111111111111111111111111111
11111111000000000000000000000000000000000000001111111111111111111111111111111
11111111000000000000000000000000000000000000001111111111111111111111111111111
11111111000000000000000000000000000000000000001111111111111111111111111111111
11111111000000000000000000000000000000000000001111111111111111111111111111111
11111111111111111111111111111111111111111111111111111111111111111111111111111
11111111111111111111111111111111111111111111111111111111111111111111111111111
11111111111111111111111111111111111111111111111111111111111111111111111111111
11111111111111111111111111111111111111111111111111111111111111111111111111111
11111111111111111111111111111111111111111111111111111111111111111111111111111
11111111111111111111111111111111111111111111111111111111111111111111111111111
11111111111111111111111111111111111111111111111111111111111111111111111111111
11111111111111111111111111111111111111111111111111111111111111111111111111111
11111111111111111111111111111111111111111111111111111111111111111111111111111
11111111111111111111111111111111111111111111111111111111111111111111111111111
11111111111111111111111111111111111111111111111111111111111111111111111111111
11111111111111111111111111111111111111111111111111111111111111111111111111111
11111111111111111111111111111111111111111111111111111111111111111111111111111
11111111111111111111111111111111111111111111111111111111111111111111111111111
11111111111111111111111111111111111111111111111111111111111111111111111111111
11111111111111111111111111111111111111111111111111111111111111111111111111111
11111111111111111111111111111111111111111111111111111111111111111111111111111
