1111111111111111111111
1000000000000000000P01
1000000E00000000000101
1111111111111111111111
