1111111111111111111111111111111111
1E0000000000000C00000C00000X000001
1010010100100000101001000000010101
10100100101010100010010000000101P1
1111111111111111111111111111111111