1111111111111111111111
10000000000000000000111
11111111111111111111111
11111111111111
1111111111111
1444444444
4444444444444444
444444444444444