111111111111111111111111111111111111111
100C100C100C100C100C100C100C100C100C101
10100C100C100C100C100C100C100C100C100C1
111111111111111111001111111111111111101
100C100C100C100C100C100C100C100C100C101
1C100C100C100C100C100C100C100C100C100C1
10000000000000X000000000000000000000011
100C100C100C100C100C100C100C100C100C101
1C100C100C100C100C100C100C100C100C100C1
111111100111111111111110011111111111101
100C100C100C100C100C100C100C100C100C101
1C100C1X0C100C100C100C100C10XC100C100C1
100000000000E00000X00000000000000000011
100C100C100C100C000C100C100C100C100C101
1C100C100C100C000C000C100C100C100C100C1
11000000X0000000X00000000X00000000X0101
100C100C100CC00C000C000C100C100C000C101
1C100C10XC10PC100C100C1000000C100C100C1
111111111111111111111111111111111111111