1111111111111111111111
100C100C100C100C000001
10100C10PC100C100EC1X1
1111111111111111111111