11111111111111111111111111111111
1E000000010001111100000C0C0C0C01
111110001110001111000C0C00C01111
1111000011100C0C01110C0C0CX00X11
1C110X0001100C010C0C1111C000X001
10000100001C1C11100001000000X0X1
1P000000000010000C00C0C0C00000X1
11111111111111111111111111111111